//level 12
{
  "map": [
    "------xxx",
    "-    -xxx",
    "- ooo--xx",
    "-  -**---",
    "--  **o -",
    "x- b    -",
    "x--------"
  ],
  "max_step": 110
}