//level 14
{
  "map": [
    "x-------xx",
    "x- *** -xx",
    "---***o---",
    "-  o-o - x",
    "- oo  -o -",
    "-    -   -",
    "---- b ---",
    "xxx-----xx"
  ],
  "max_step": 200
}