//level 16
{
  "map": [
    "--------x",
    "-      -x",
    "- -oo  -x",
    "- ***- -x",
    "--***o --",
    "x- -- o -",
    "x-o  o  -",
    "x-  -  b-",
    "x--------"
  ],
  "max_step": 120
}