//level 10
{
  "map": [
    "xx------",
    "xx-    -",
    "---ooo -",
    "-b o** -",
    "- o***--",
    "----  -x",
    "xxx----x"
  ],
  "max_step": 80
}