//level 13
{
  "map": [
    "xx--------",
    "xx-   -* -",
    "x--  o***-",
    "x-  o -**-",
    "-- --o-o--",
    "-   o    -",
    "-   -  o -",
    "-------b -",
    "xxxxxx----"
  ],
  "max_step": 160
}