//level 9
{
  "map": [
    "x---------x",
    "x-  --   -x",
    "x-   o   -x",
    "x-o --- o-x",
    "x- -***- -x",
    "-- -***- --",
    "- o  o  o -",
    "-     - b -",
    "-----------"
  ],
  "max_step": 220
}