//level 21
{
  "map": [
    "xxxxx-----xx",
    "----x-   --x",
    "-  ---o-  -x",
    "- o ****- --",
    "-  --****  -",
    "-    o--o- -",
    "- o-o   o  -",
    "-- b ---o- -",
    "x-----x-   -",
    "xxxxxxx-----"
  ],
  "max_step": 300
}