//level 25
{
  "map": [
    "------------xx",
    "-**  -     ---",
    "-**  - o  o  -",
    "-**  -o----  -",
    "-**    b --  -",
    "-**  - -  o --",
    "------ --o o -",
    "xx- o  o o o -",
    "xx-    -     -",
    "xx------------"
  ],
  "max_step": 950
}