//level 18
{
  "map": [
    "------xxx-----",
    "-    --- -  *-",
    "-  o o - -***-",
    "- -  o ---  *-",
    "-  ooo   o b*-",
    "---  o  o-  *-",
    "xx-  o-o -***-",
    "xx--     -  *-",
    "xxx-----------"
  ],
  "max_step": 400
}