{
  "map": [
    "----------",
    "-**      -",
    "-**o  -  -",
    "-  -o-- --",
    "- o     -x",
    "----- - -x",
    "xx- o b -x",
    "xx-     -x",
    "xx-------x"
  ],
  "max_step": 140
}