//level 32
{
  "map": [
    "xxx----------x",
    "----******  -x",
    "-   *****-  -x",
    "-  -****** --x",
    "-- ----o--o-xx",
    "-bo  o o   ---",
    "- oo    --   -",
    "- -  oo--  - -",
    "-   o  - oo  -",
    "-  o  o   -o -",
    "----   - o o -",
    "xxx-   -     -",
    "xxx-----------"
  ],
  "max_step": 1000
}