{
  "map": [
    "x-------x",
    "x- b***-x",
    "x-   ----",
    "---o    -",
    "-   -o- -",
    "- o -   -",
    "-   -----",
    "-----xxxx"
  ],
  "max_step": 90
}