{
  "map": [
    "x----x",
    "--  -x",
    "-bo -x",
    "--o --",
    "-- o -",
    "-*o  -",
    "-** *-",
    "------"
  ],
  "max_step": 50
}