//level 4
{
  "map": [
    "x-------xx",
    "x-     ---",
    "--o---   -",
    "- b o  o -",
    "- **- o --",
    "--**-   -x",
    "x--------x"
  ],
  "max_step": 140
}
