//level 6
{
  "map": [
    "xxx-------xxx",
    "----     -xxx",
    "-   *--- -xxx",
    "- - -    --  ",
    "- -   o-* -xx",
    "- -  o  - -xx",
    "- *-o o - -xx",
    "--    - - ---",
    "x- ---*    b-",
    "x-     --   -",
    " ------------"
  ],
  "max_step": 150
}