//level 7
{
  "map": [
    "xxx-------",
    "xx--  - b-",
    "xx-   -  -",
    "xx-o o o -",
    "xx- o--  -",
    "--- o - --",
    "-*****  -x",
    "---------x"
  ],
  "max_step": 120
}